##########
#..@..@@.#
#@######.#
#.#.1..#@#
#.#@##.#.#
#@#@##.#@#
#.#.#0.#.#
#.#@####@#
#.#..@.@.#
#z########

